NO ./path_to_the_north_texture
SO ./path_to_the_south_texture
WE ./path_to_the_west_texture
EA ./path_to_the_east_texture

F 30,163,15
C 97,192,255

111111111
1N0000001
100000001
100000001
111111111