NO ./path_to_the_north_texture
SO ./path_to_the_south_texture
WE ./path_to_the_west_texture
EA ./path_to_the_east_texture

F 30,163,15
C 97,192,255

111111111
100000001
10N000001
101010101
111111111